****************
*   *          *
*   *          *
**  *          *
*              *
*          *****
*              *
****       *   *
*  *       *****
*  ****        *
*  *           *
*  *  *        *
*  ****        *
*              *
*              *
****************